000000000000000000000000000000000000000000000000000000000000000000000000000000000000000000000000000000000000000000000
000000000000000000000000000000000000000000000000000000000000000000000000000000000000000000000000000000000000000000000
000000000000000000000000000000000000000000000000000000000000000000000000000000000000000000000000000000000000000000000
040000000000000000000004000000000000000000000000000000000000000000000000000000000000000000000000000000000000000000000
111111000000000000001111110000000000000000000000000000000000000000000000000000000000000000000000000000000000000000000
000000000040000000000000000000000000000001110000000000000000000000000000000000000000000000000000000000000000000000000
000000000111100000000000000001111000000000000000000000000000000000000000000000000000000000000000000000000000000000000
000000000000000010000005000000000000110000000000000000000000000000000000000000000000000000000000000000000000000000040
140050010000000000001000400100000000000000000000000000000000000000000000000000000000000000000000000000000000000001111
111111110000000000001111111100000000000000000000000000000000000000000000000000000000000000000000000400000004000000000
000000000000000000000000000000000000000000000000000000000000000000000000000000000000000000000000011110000111110000000
000000000000000000000000000001000000000000000000000000000000000000040000000000000000000000004000000000000000000000000
000000000100050000000000000000005000000000000000000000000000000000111100000000000000000000011110000000000000000000000
002000000000000000000000000000000000000000000000000000000000000000000000000000000000040000000000000000000000000000000
000000000000000000000000000010040001000000000000000400000010540100000000100450010001111100000000000000000000000000000
011100001111111100000111000011111111000000000000011111000011111100000000111111110000000000000000000000000000000000000
011100000000000000000111000000000000000000000000000000000000000000000000000000000000000000000000000000000000000000000
011100000000000000000111000000000000000000000000000000000000000000000000000000000000000000000000000000000000000000000
011100000000000000000111000000000000000000000000000000000000000000000000000000000000000000000000000000000000000000000